############################
#.P........................#
#.####.##.########.##.####.#
#.####.##.###b####.##.####.#
#............e.............#
######.#####.##.#####.######
p#####.#####.##.#####.######
i#####G              .######
c###########################