#############
#############
#...###...###
#.p.P...i.###
#...#.#...###
#####e#######
#...#.#...###
#.b.....c.###
#...# #...###
##### #######
##### ## G  #
##### ## ## #
#####       #
#############