#################
#P..............#
#.#.i.#e#.#.b.#.#
#...............#
#.#ep.#.#.#.c.#.#
#.............G.#
#################