#################
#P..............#
#.#.i.#.#.#.b.#.#
#...............#
#.#.p.#.#e#.c # #
#............ G #
#################